{
  "name": "标准走廊（新手图）",
  "description": "均衡地图，主通道宽敞，传送带辅助移动，能量分布均匀。适合测试基础策略。",
  "layout": [
    "####################################",
    "#..................................#",
    "#.AAAAA......................BBBBB.#",
    "#..................................#",
    "#..................................#",
    "#....3....................4........#",
    "#..................................#",
    "#..................................#",
    "#....^......................^......#",
    "#....^......................^......#",
    "#....^......................^......#",
    "#....^......................^......#",
    "#....^......................^......#",
    "#....^......................^......#",
    "#....^......................^......#",
    "#....^......................^......#",
    "#...7.>>>>>>>>0<<<<<<<<.8.........##",
    "#..................................#",
    "#...9.>>>>>>>>2<<<<<<<<.a.........##",
    "#....v......................v......#",
    "#....v......................v......#",
    "#....v......................v......#",
    "#....v......................v......#",
    "#....v......................v......#",
    "#....v......................v......#",
    "#....v......................v......#",
    "#....v......................v......#",
    "#....v......................v......#",
    "#....v......................v......#",
    "#....5....................6........#",
    "#..................................#",
    "#..................................#",
    "#..................................#",
    "#..................................#",
    "#..................................#",
    "####################################"
  ],
  "cabinets": {
    "0": 1600,
    "1": 1180,
    "2": 920,
    "3": 760,
    "4": 700,
    "5": 640,
    "6": 600,
    "7": 540,
    "8": 500,
    "9": 440,
    "a": 380
  }
}