{
  "name": "沙漏（卡口图）",
  "description": "地图中央只有一个单格通道连接两侧，所有机架都在对方半场。必须穿越卡口才能得分，极易形成堵塞和对抗。",
  "layout": [
    "####################################",
    "####################################",
    "#.AAAAA..........................###",
    "#..................................#",
    "#..................................#",
    "#....3.............................#",
    "#..................................#",
    "#..................................#",
    "#..................................#",
    "#..................................#",
    "#..................................#",
    "#..................................#",
    "#..................................#",
    "#..................................#",
    "#..................................#",
    "#..................................#",
    "#..................................#",
    "#################.##################",
    "#..................................#",
    "#..................................#",
    "#..................................#",
    "#..................................#",
    "#..................................#",
    "#..................................#",
    "#..................................#",
    "#..................................#",
    "#..................................#",
    "#..................................#",
    "#..................................#",
    "#..................................#",
    "#...........................4......#",
    "#..................................#",
    "#..................................#",
    "#.........................BBBBB....#",
    "####################################",
    "####################################"
  ],
  "cabinets": {
    "3": 1400,
    "4": 1400
  }
}
