{
  "name": "迷宫（死胡同图）",
  "description": "密集内墙形成大量死胡同，高价值能量藏在死胡同尽头。传送带陷阱会把你推进死路。机架分散在各个角落，路径规划极其复杂。",
  "layout": [
    "####################################",
    "#..................................#",
    "#.AA.#####.#.#####.#.#####.#.BB..###",
    "#.AA.#...#.#.#...#.#.#...#.#.BB..###",
    "#....#.#.#.#.#.#.#.#.#.#.#.#.....###",
    "#....#.#...#.#.#...#.#.#...#.....###",
    "#....#.#####.#.#####.#.#####.....###",
    "#............................3....##",
    "#.####.####.####.####.####.####..###",
    "#.#..#.#..#.#..#.#..#.#..#.#..#..###",
    "#.#..#.#..#.#..#.#..#.#..#.#..#..###",
    "#.#..#.#..#.#..#.#..#.#..#.#..#..###",
    "#.####.####.####.####.####.####..###",
    "#............................4....##",
    "#.####.####.####.####.####.####..###",
    "#.#..#.#..#.#..#.#..#.#..#.#..#..###",
    "#.#..#.#..#.#..#.#..#.#..#.#..#..###",
    "#.#..#.#..#.#..#.#..#.#..#.#..#..###",
    "#.####.####.####.####.####.####..###",
    "#............................5....##",
    "#.####.####.####.####.####.####..###",
    "#.#..#.#..#.#..#.#..#.#..#.#..#..###",
    "#.#..#.#..#.#..#.#..#.#..#.#..#..###",
    "#.#..#.#..#.#..#.#..#.#..#.#..#..###",
    "#.####.####.####.####.####.####..###",
    "#............................6....##",
    "#.####.####.####.####.####.####..###",
    "#.#..#.#..#.#..#.#..#.#..#.#..#..###",
    "#.#..#.#..#.#..#.#..#.#..#.#..#..###",
    "#.#..#.#..#.#..#.#..#.#..#.#..#..###",
    "#.####.####.####.####.####.####..###",
    "#............................7....##",
    "#..................................#",
    "#..................................#",
    "#..................................#",
    "####################################"
  ],
  "cabinets": {
    "0": 1200,
    "1": 1000,
    "2": 900,
    "3": 800,
    "4": 800,
    "5": 800,
    "6": 800,
    "7": 800
  }
}