{
  "name": "孤岛（传送带陷阱图）",
  "description": "所有高价值机架在四个孤岛上，只能通过传送带进入。传送带是单向的，进去容易出来难。岛内空间极小，两个机器人同时进入必然堵死。",
  "layout": [
    "####################################",
    "#..................................#",
    "#.AAAAA..........................#.#",
    "#..................................#",
    "#..................................#",
    "#....######.........######.........#",
    "#....#0...#.........#1...#.........#",
    "#....#....#.........#....#.........#",
    "#....#....#.........#....#.........#",
    "#....##v###.........##v##..........#",
    "#......v...............v...........#",
    "#......v...............v...........#",
    "#......>>>>>....<<<<<<<............#",
    "#..................................#",
    "#..................................#",
    "#..................................#",
    "#..................................#",
    "#..................................#",
    "#..................................#",
    "#..................................#",
    "#..................................#",
    "#......>>>>>....<<<<<<<<...........#",
    "#......^...............^...........#",
    "#......^...............^...........#",
    "#....##^###.........##^##..........#",
    "#....#....#.........#....#.........#",
    "#....#....#.........#....#.........#",
    "#....#2...#.........#3...#.........#",
    "#....######.........######.........#",
    "#..................................#",
    "#..................................#",
    "#..................................#",
    "#..........................BBBBB...#",
    "#..................................#",
    "#..................................#",
    "####################################"
  ],
  "cabinets": {
    "0": 2400,
    "1": 2400,
    "2": 2400,
    "3": 2400
  }
}
