{
  "name": "荒漠（极限资源图）",
  "description": "能量极度稀缺，且全部集中在对方出生区附近的深区。机架只有两个，容量极小。必须深入敌境抢能量，同时防守自己的机架。每一分都来之不易。",
  "layout": [
    "####################################",
    "#..................................#",
    "#.AAAAA............................#",
    "#..................................#",
    "#..................................#",
    "#..................................#",
    "#..................................#",
    "#..................................#",
    "#..................................#",
    "#..................................#",
    "#..................................#",
    "#..................................#",
    "#..................................#",
    "#..................................#",
    "#..................................#",
    "#..................................#",
    "#................0.................#",
    "#..................................#",
    "#..................................#",
    "#..................................#",
    "#..................................#",
    "#..................................#",
    "#..................................#",
    "#..................................#",
    "#..................................#",
    "#..................................#",
    "#..................................#",
    "#..................................#",
    "#..................................#",
    "#..................................#",
    "#..................................#",
    "#..................................#",
    "#............................BBBBB.#",
    "#..................................#",
    "#..................................#",
    "####################################"
  ],
  "cabinets": {
    "0": 800
  },
  "energy_zones": {
    "deep": [
      [2,2],[3,2],[4,2],[5,2],[6,2],[7,2],[8,2],
      [2,3],[2,4],[2,5],[2,6],[2,7],[2,8],
      [29,27],[30,27],[31,27],[32,27],[33,27],
      [29,28],[29,29],[29,30],[29,31],[29,32],
      [30,28],[31,28],[32,28],[33,28],
      [30,29],[31,29],[32,29],[33,29]
    ],
    "main": [],
    "side": []
  }
}
