{
  "name": "独木桥（单行道图）",
  "description": "两侧基地之间只有一条宽度为1的蜿蜒小路连接。5个机器人挤一条道，堵车是常态。谁先占住路口谁就是爷。干扰技能在这里价值翻倍。",
  "layout": [
    "####################################",
    "#AAAAA##############################",
    "#.....##############################",
    "###.################################",
    "###.################################",
    "###.################################",
    "###.....############################",
    "########.###########################",
    "########.###########################",
    "########.###########################",
    "########.....#######################",
    "#############.######################",
    "#############.######################",
    "#############.######################",
    "#############.....##################",
    "##################.#################",
    "##################.#0###############",
    "##################...###############",
    "##################.#################",
    "##################.....#############",
    "#######################.############",
    "#######################.############",
    "#######################.############",
    "#######################.....########",
    "############################.#######",
    "############################.#######",
    "############################.#######",
    "############################.....1.#",
    "#################################.##",
    "#################################.##",
    "#################################.##",
    "##############################.....#",
    "##############################.#####",
    "##############################.BBBBB",
    "##############################.....#",
    "####################################"
  ],
  "cabinets": {
    "0": 3000,
    "1": 3000
  }
}
