{
  "name": "螺旋（漩涡图）",
  "description": "传送带形成三层螺旋，把机器人卷向中心。中心有唯一高价值机柜。逆流而上极其困难，顺流而下一去不返。",
  "layout": [
    "####################################",
    "#..................................#",
    "#AAAAA.............................#",
    "#..................................#",
    "#...>>>>>>>>>>>>>>>>>>>>>>>>>>>>...#",
    "#..............................v...#",
    "#..............................v...#",
    "#......>>>>>>>>>>>>>>>>>>>>>>..v...#",
    "#......^....................v..v...#",
    "#......^....................v..v...#",
    "#......^..>>>>>>>>>>>>>>>>..v..v...#",
    "#......^..^..............v..v..v...#",
    "#......^..^..............v..v..v...#",
    "#......^..^..............v..v..v...#",
    "#......^..^..............v..v..v...#",
    "#......^..^..............v..v..v...#",
    "#......^..^..............v..v..v...#",
    "#......^..^......0.......v..v..v...#",
    "#......^..^..............v..v..v...#",
    "#......^..^..............v..v..v...#",
    "#......^..^..............v..v..v...#",
    "#......^..^..............v..v..v...#",
    "#......^..^..............v..v..v...#",
    "#......^..^..............v..v..v...#",
    "#......^..^..............v..v..v...#",
    "#......^..^<<<<<<<<<<<<<<<..v..v...#",
    "#......^....................v..v...#",
    "#......^....................v..v...#",
    "#......^<<<<<<<<<<<<<<<<<<<<<..v...#",
    "#..............................v...#",
    "#..............................v...#",
    "#...<<<<<<<<<<<<<<<<<<<<<<<<<<<<...#",
    "#..................................#",
    "#.............................BBBBB#",
    "#..................................#",
    "####################################"
  ],
  "cabinets": {
    "0": 5000
  }
}