{
  "name": "蚁穴（多层迷宫图）",
  "description": "地图被分成上中下三层，层与层之间只有狭窄的楼梯通道连接。机柜分散在各层，机器人必须在层间穿梭。楼梯口是兵家必争之地。",
  "layout": [
    "####################################",
    "#..................................#",
    "#AAAAA........................BBBBB#",
    "#.....0......................1.....#",
    "#..................................#",
    "#..................................#",
    "########.##################.########",
    "#..................................#",
    "#.....2......................3.....#",
    "#..................................#",
    "#..................................#",
    "########.##################.########",
    "#..................................#",
    "#..................................#",
    "#..................................#",
    "#...>>>>>>>>>>>>....<<<<<<<<<<<<...#",
    "#.....4......................5.....#",
    "#..................................#",
    "#..................................#",
    "#..................................#",
    "#...<<<<<<<<<<<<....>>>>>>>>>>>>...#",
    "#.....6......................7.....#",
    "#..................................#",
    "#..................................#",
    "########.##################.########",
    "#..................................#",
    "#..................................#",
    "#..................................#",
    "#.....8......................9.....#",
    "#..................................#",
    "#..................................#",
    "#..................................#",
    "#.....a......................b.....#",
    "#..................................#",
    "#..................................#",
    "####################################"
  ],
  "cabinets": {
    "0": 800,
    "1": 800,
    "2": 800,
    "3": 800,
    "4": 1200,
    "5": 1200,
    "6": 1200,
    "7": 1200,
    "8": 800,
    "9": 800,
    "a": 800,
    "b": 800
  }
}