{
  "name": "绞肉机（传送带对撞图）",
  "description": "地图中央是两条相向的传送带高速公路，机器人一旦踏上就会被送向对方阵营。机柜全在传送带尽头，必须顺流抢分再逆流回家。被干扰在传送带上等于白送。",
  "layout": [
    "####################################",
    "#..................................#",
    "#.AAAAA............................#",
    "#..................................#",
    "#..................................#",
    "#..0...............................#",
    "#..................................#",
    "#..................................#",
    "#..................................#",
    "#..................................#",
    "#..1...............................#",
    "#..................................#",
    "#..................................#",
    "#>>>>>>>>>>>>>>>>>>>>>>>>>>>>>>>>>.#",
    "#..................................#",
    "#..................................#",
    "#..................................#",
    "#..................................#",
    "#..................................#",
    "#..................................#",
    "#..................................#",
    "#.<<<<<<<<<<<<<<<<<<<<<<<<<<<<<<<..#",
    "#..................................#",
    "#..................................#",
    "#...............................2..#",
    "#..................................#",
    "#..................................#",
    "#..................................#",
    "#..................................#",
    "#...............................3..#",
    "#..................................#",
    "#..................................#",
    "#............................BBBBB.#",
    "#..................................#",
    "#..................................#",
    "####################################"
  ],
  "cabinets": {
    "0": 1800,
    "1": 1800,
    "2": 1800,
    "3": 1800
  }
}
