{
  "name": "监狱（牢房图）",
  "description": "每个机器人出生在独立的牢房里，只有一个窄出口通向走廊。机柜在中央放风区，走廊极窄。团队配合和路径规划是唯一的出路。",
  "layout": [
    "####################################",
    "#####.########################.#####",
    "#.....########################.....#",
    "#A....########################....B#",
    "#.....########################.....#",
    "#####.########################.#####",
    "#####.########################.#####",
    "#.....########################.....#",
    "#A....########################....B#",
    "#.....########################.....#",
    "#####.#####..............#####.#####",
    "#####.#####..............#####.#####",
    "#..................................#",
    "#A....#####..............#####....B#",
    "#.....#####..............#####.....#",
    "#####.#####..............#####.#####",
    "#####.#####.....0..1.....#####.#####",
    "#.....#####..............#####.....#",
    "#A....#####..............#####....B#",
    "#.....#####..............#####.....#",
    "#####.#####.....2..3.....#####.#####",
    "#####.#####..............#####.#####",
    "#.....#####..............#####.....#",
    "#A....#####..............#####....B#",
    "#.....#####..............#####.....#",
    "#####.#####..............#####.#####",
    "#####.########################.#####",
    "#####.########################.#####",
    "#####.########################.#####",
    "#####.########################.#####",
    "#####.########################.#####",
    "#####.########################.#####",
    "#####.########################.#####",
    "#####.########################.#####",
    "#####.########################.#####",
    "####################################"
  ],
  "cabinets": {
    "0": 2000,
    "1": 2000,
    "2": 2000,
    "3": 2000
  }
}