{
  "name": "竞技场（钻石图）",
  "description": "菱形竞技场，中心有传送带漩涡。X形内墙把场地分成四个象限，机柜分布在十字路口。空间开阔但内墙制造了大量视野盲区。",
  "layout": [
    "####################################",
    "####################################",
    "####################################",
    "##################.#################",
    "#################...################",
    "################.....###############",
    "###############.......##############",
    "##############.........#############",
    "#############...........############",
    "############.............###########",
    "###########...............##########",
    "##########.#.............#.#########",
    "#########...#.....1.....#...########",
    "########.....#.........#.....#######",
    "#######.......>>>>>>>>v.......######",
    "######........^#.....#v........#####",
    "##.A..........^.......v.........B.##",
    "##.A..........^.......v.........B.##",
    "##.A........3.^...0...v.4.......B.##",
    "##.A..........^.......v.........B.##",
    "##.A..........^.......v.........B.##",
    "######........^#.....#v........#####",
    "#######.......^<<<<<<<<.......######",
    "########.....#.........#.....#######",
    "#########...#.....2.....#...########",
    "##########.#.............#.#########",
    "###########...............##########",
    "############.............###########",
    "#############...........############",
    "##############.........#############",
    "###############.......##############",
    "################.....###############",
    "#################...################",
    "##################.#################",
    "####################################",
    "####################################"
  ],
  "cabinets": {
    "0": 2000,
    "1": 1200,
    "2": 1200,
    "3": 1200,
    "4": 1200
  }
}